*===============*
|     STAGE     |
|               |
|               |
|               |
|               |
*===============*